Name,Group,Brand,Jan,Feb,Mar,Apr,May,Jun,First Half,Jul,Aug,Sep,Oct,Nov,Dec,Second Half,Adjusted Value,Total
Mini Cars,Toyota Group,Toyota,1305,1247,2015,1668,999,1207,8441,1758,1952,1917,1999,1919,1701,11246,0,19687
,,Daihatsu,31649,37579,46149,23698,10711,25863,175649,40148,29494,38197,41240,37202,32963,219244,0,394893
,Renault-Nissan Alliance,Nissan,14699,15950,19713,6509,7925,16209,81005,13844,10928,18694,11955,14867,12625,82913,0,163918
,Honda,Honda,23020,30724,32815,19003,12956,19449,137967,22685,20618,27896,22180,23248,19845,136472,0,274439
,Suzuki,Suzuki,31815,36533,49389,19756,15255,33433,186181,38417,32371,43896,34953,35383,32279,217299,0,403480
,Mazda,Mazda,1845,2256,5027,1603,944,1468,13143,2705,2533,3329,2563,2321,1987,15438,0,28581
,Mitsubishi,Mitsubishi,2919,3421,6713,1327,1357,3102,18839,2387,2169,3368,2546,2057,2380,14907,0,33746
,Subaru,Subaru,1117,1182,1513,991,474,1023,6300,1349,935,1171,987,866,712,6020,0,12320
,Small and Medium OEM,Other,5,5,8,2,2,11,33,5,9,8,13,5,12,52,0,85
Small Cars,VW Group,VW,254,234,419,97,80,130,1214,138,104,169,61,16,14,502,0,1716
,,Porsche (2013-),2,2,4,4,6,3,21,1,2,2,2,2,1,10,0,31
,,Bugatti,0,0,0,0,0,0,0,0,0,0,1,0,0,1,0,1
,Toyota Group,Toyota,48390,59527,81740,46669,39977,47482,323785,56509,45966,57638,56574,48892,44090,309669,0,633454
,,Daihatsu,5130,6207,10285,3346,2535,3351,30854,4120,3742,6074,5096,3074,2943,25049,0,55903
,Renault-Nissan Alliance,Nissan,9526,13461,14735,5038,4637,7667,55064,8786,5537,8668,5717,5299,7151,41158,0,96222
,,Renault,143,189,348,186,137,199,1202,203,235,270,164,146,115,1133,0,2335
,Honda,Honda,10838,16805,25040,15372,11239,15219,94513,15451,12087,16958,16847,13806,12636,87785,0,182298
,FCA,Fiat (-2020),240,353,655,176,223,409,2056,296,273,537,444,363,593,2506,0,4562
,,Abarth (-2020),112,193,319,77,196,353,1250,138,107,323,183,189,381,1321,0,2571
,,Alfa Romeo (-2020),1,1,1,1,1,1,6,0,1,2,1,1,1,6,0,12
,,Lancia (-2020),0,0,1,1,1,0,3,0,0,1,0,1,1,3,0,6
,PSA,Peugeot (-2020),1,0,0,0,0,0,1,0,0,0,0,0,0,0,0,1
,,Citroen (-2020),0,1,0,2,1,1,5,1,0,2,2,0,1,6,0,11
,Suzuki,Suzuki,8113,9140,12470,5265,3212,7057,45257,8612,6909,9309,6488,7325,8324,46967,0,92224
,Daimler Group (-2021),Mercedes-Benz (-2021),0,0,0,0,0,0,0,0,0,1,0,0,0,1,0,1
,,smart (-2021),55,24,31,3,3,2,118,1,2,2,1,0,0,6,0,124
,BMW Group,BMW,1,0,0,0,0,0,1,0,1,1,0,1,1,4,0,5
,,MINI,0,1,1,0,2,0,4,0,0,0,0,0,1,1,0,5
,Mazda,Mazda,2189,2413,5623,1260,1510,1923,14918,2128,1979,3354,2161,2158,1770,13550,0,28468
,Geely Holding Group,Lotus (2017-),1,1,0,1,1,2,6,0,1,1,3,0,1,6,0,12
,Mitsubishi,Mitsubishi,551,738,1019,244,235,444,3231,577,375,684,309,160,361,2466,0,5697
,Subaru,Subaru,211,250,426,145,123,184,1339,117,217,93,181,132,166,906,0,2245
,Tata Group,Land Rover (2008-),1,1,0,0,0,0,2,0,0,0,0,0,0,0,0,2
,SAIC (Shanghai Automotive Industry Corporation (Group)),MG (2006-),2,1,0,5,1,1,10,0,1,1,0,0,3,5,0,15
,,Rover,0,1,1,1,3,3,9,2,4,4,2,2,9,23,0,32
,Small and Medium OEM,Autobianchi,4,7,3,5,5,11,35,13,5,4,4,8,5,39,0,74
,,Innocenti,0,0,0,0,0,0,0,0,0,0,1,0,0,1,0,1
,,Morgan,5,2,3,2,2,0,14,0,1,0,0,0,1,2,0,16
,,Other,0,3,1,3,2,4,13,2,3,3,5,5,2,20,0,33
Cars,VW Group,VW,2573,3651,4893,1510,1525,2622,16774,2399,2910,4729,2819,2482,2745,18084,0,34858
,,Audi,1544,1807,2303,737,1072,1822,9285,1476,1748,3026,2122,2005,2642,13019,0,22304
,,Porsche (2013-),409,546,1049,489,450,802,3745,262,501,930,266,461,1088,3508,0,7253
,,Bentley,27,30,42,32,23,67,221,48,27,40,24,31,72,242,0,463
,,Lamborghini,72,84,58,80,49,67,410,21,21,66,40,43,30,221,0,631
,,Bugatti,0,1,0,0,0,0,1,0,0,0,0,0,0,0,0,1
,Toyota Group,Toyota,45128,50975,70883,33292,28190,41631,270099,52298,41686,69918,66453,70506,59650,360511,0,630610
,,Daihatsu,7,3,11,8,2,9,40,13,0,7,3,12,6,41,0,81
,,Lexus,4797,4233,5736,3203,3752,3505,25226,2849,2523,3902,3835,5630,5094,23833,0,49059
,Renault-Nissan Alliance,Nissan,10595,13325,12503,3606,4207,8649,52885,9982,8001,12021,10046,11600,10202,61852,0,114737
,,Renault,280,331,584,108,177,329,1809,267,235,463,333,224,297,1819,0,3628
,GM Group,Chevrolet,14,22,22,16,9,15,98,11,28,86,53,23,39,240,0,338
,,Buick,2,1,0,0,1,2,6,0,0,0,1,0,3,4,0,10
,,GMC,1,0,1,1,1,1,5,0,2,2,1,1,2,8,0,13
,,Cadillac,44,55,61,16,20,51,247,31,28,54,30,33,36,212,0,459
,,Hummer,0,0,0,0,0,1,1,0,0,0,0,0,0,0,0,1
,,Pontiac,1,1,0,0,0,0,2,1,1,1,1,1,1,6,0,8
,Hyundai Kia Automotive Group,Hyundai,0,6,1,1,1,0,9,0,0,0,0,0,4,4,0,13
,Ford Group,Ford,24,34,30,30,31,31,180,46,32,45,38,45,54,260,0,440
,Honda,Honda,8846,11156,14395,6974,5389,9459,56219,10420,7073,10132,9636,9669,8353,55283,0,111502
,FCA,Fiat (-2020),31,65,149,70,44,81,440,97,159,195,154,132,150,887,0,1327
,,Jeep (2009-20),895,987,1415,621,680,1157,5755,998,940,1821,1436,1272,1340,7807,0,13562
,,Dodge (2009-20),17,38,35,32,20,43,185,25,46,42,42,37,57,249,0,434
,,Chrysler (2009-20),3,0,3,0,1,2,9,2,0,4,2,2,2,12,0,21
,,Abarth (-2020),13,15,62,29,30,67,216,85,46,66,30,15,3,245,0,461
,,Alfa Romeo (-2020),103,116,219,57,59,136,690,66,58,172,178,223,275,972,0,1662
,,Ferrari (-2020),90,101,117,71,102,67,548,47,58,114,119,104,95,537,0,1085
,,Lancia (-2020),1,1,0,1,0,1,4,0,1,0,0,0,0,1,0,5
,,Maserati (-2020),34,55,132,31,35,90,377,63,67,109,79,66,137,521,0,898
,PSA,Peugeot (-2020),678,713,1266,335,514,817,4323,734,553,1011,1626,1307,1197,6428,0,10751
,,Citroen (-2020),279,305,560,288,188,324,1944,351,310,563,536,520,793,3073,0,5017
,,DS (-2020),68,43,78,30,35,62,316,73,91,121,107,83,117,592,0,908
,Suzuki,Suzuki,1350,1369,1962,800,459,1238,7178,1502,1310,1788,1307,1161,768,7836,0,15014
,Daimler Group (-2021),Mercedes-Benz (-2021),4175,4292,6922,2286,2691,4609,24975,4620,3979,7070,4463,5640,6251,32023,0,56998
,,Maybach (-2021),0,0,0,0,1,0,1,0,0,0,0,0,0,0,0,1
,BMW Group,BMW,1710,2738,4807,1695,1714,3236,15900,2507,2473,4239,3042,3562,4148,19971,0,35871
,,MINI,1000,1475,2295,943,1046,1714,8473,1670,1633,2453,1799,1835,2333,11723,0,20196
,,Rolls-Royce,21,13,16,12,10,23,95,18,12,23,23,26,29,131,0,226
,Mazda,Mazda,9547,11339,17118,4201,3599,5778,51582,7070,8140,12181,7830,7167,8163,50551,0,102133
,Geely Holding Group,Volvo Cars (2011-),1278,1393,1864,740,996,1156,7427,1310,1030,1504,1220,1251,1805,8120,0,15547
,,Lotus (2017-),21,13,32,16,19,16,117,15,14,14,19,34,50,146,0,263
,Mitsubishi,Mitsubishi,2630,2471,3524,725,665,1089,11104,1279,1173,1927,1353,1355,3601,10688,0,21792
,Subaru,Subaru,8245,9157,12703,3442,1581,6301,41429,7337,4538,6324,5688,8281,8931,41099,0,82528
,Tata Group,Land Rover (2008-),282,373,580,142,129,344,1850,224,169,268,321,434,677,2093,0,3943
,,Jaguar (2008-),79,133,224,51,93,200,780,106,77,109,93,108,150,643,0,1423
,Aston Martin,Aston Martin (2008-),20,18,24,14,6,16,98,16,11,17,20,16,18,98,0,196
,SAIC (Shanghai Automotive Industry Corporation (Group)),Rover,0,0,2,1,0,0,3,0,1,1,1,0,0,3,0,6
,Small and Medium OEM,De Tomaso,0,0,0,0,1,0,1,0,0,0,1,0,0,1,0,2
,,McLaren,25,22,15,12,14,19,107,15,12,19,21,18,13,98,0,205
,,Morgan,0,0,1,1,0,1,3,12,2,0,1,2,0,17,0,20
,,Other,92,94,43,22,18,32,301,12,70,693,28,43,704,1550,0,1851
Minivan,Toyota Group,Toyota,519,644,703,594,554,577,3591,781,887,520,575,619,622,4004,0,7595
,,Daihatsu,4776,5142,6705,4347,3528,6068,30566,6052,4157,5741,6255,7802,5114,35121,0,65687
,Renault-Nissan Alliance,Nissan,2239,2561,3191,1416,1542,2419,13368,2126,1758,2921,2215,3155,1936,14111,0,27479
,Honda,Honda,2687,2836,3692,2482,2131,2808,16636,2490,2284,2435,2787,2993,2767,15756,0,32392
,Suzuki,Suzuki,5327,6106,7538,3365,2014,3761,28111,5736,4861,6740,5624,7740,5437,36138,0,64249
,Mazda,Mazda,381,439,681,236,106,201,2044,520,545,525,399,380,310,2679,0,4723
,Mitsubishi,Mitsubishi,465,613,863,309,344,386,2980,521,346,589,442,498,350,2746,0,5726
,Subaru,Subaru,353,337,453,322,266,225,1956,279,337,427,349,340,250,1982,0,3938
Mini Trucks,Toyota Group,Toyota,247,287,354,335,280,345,1848,452,495,260,369,351,316,2243,0,4091
,,Daihatsu,5921,6135,7783,5140,4223,5821,35023,6635,4768,7522,7320,7519,6925,40689,0,75712
,Renault-Nissan Alliance,Nissan,803,843,1105,598,604,925,4878,1054,948,1318,1004,973,683,5980,0,10858
,Honda,Honda,1302,1319,1638,1174,1038,1407,7878,1608,1253,2086,1904,1927,1845,10623,0,18501
,Suzuki,Suzuki,4429,4789,7041,2789,2569,5083,26700,4601,4211,5575,4953,5461,4374,29175,0,55875
,Mazda,Mazda,211,214,446,127,60,158,1216,205,156,250,187,189,134,1121,0,2337
,Mitsubishi,Mitsubishi,254,307,452,137,156,278,1584,274,186,372,280,319,249,1680,0,3264
,Subaru,Subaru,351,414,496,326,269,287,2143,359,406,428,448,397,327,2365,1,4509
,Small and Medium OEM,Other,0,0,0,1,0,0,1,0,0,1,0,1,0,2,0,3
Light Trucks,Toyota Group,Toyota,9751,11427,15223,10013,8439,11266,66119,11621,9388,13068,12137,12434,10481,69129,0,135248
,,Daihatsu,0,0,0,0,0,0,0,0,0,0,36,9,25,70,0,70
,,Hino,591,620,1236,487,502,784,4220,666,722,1064,677,840,818,4787,0,9007
,Renault-Nissan Alliance,Nissan,4030,5134,6735,3493,3146,4383,26921,4022,3314,5180,3763,4071,3344,23694,0,50615
,GM Group,Chevrolet,0,0,0,0,1,0,1,0,0,0,0,0,0,0,0,1
,PSA,Citroen (-2020),0,0,0,0,1,0,1,0,0,0,0,0,0,0,0,1
,Daimler Group (-2021),Mitsubishi Fuso (2004-21),1103,1263,2664,900,799,1224,7953,1173,1157,1583,1384,1374,1677,8348,0,16301
,Mazda,Mazda,987,1117,1570,841,803,869,6187,776,594,869,776,638,531,4184,0,10371
,Mitsubishi,Mitsubishi,6,7,7,3,3,2,28,2,0,25,0,0,0,27,0,55
,Isuzu,Isuzu,593,714,1479,511,546,778,4621,739,818,1511,604,795,843,5310,0,9931
,Volvo Trucks Group,UD Trucks (2008-),7,4,19,5,2,8,45,6,6,5,7,9,5,38,0,83
Trucks,VW Group,VW,0,0,0,0,0,0,0,0,0,1,0,0,1,2,0,2
,,Scania (TRATON),22,25,39,24,21,24,155,23,28,35,29,25,39,179,0,334
,Toyota Group,Toyota,1469,1664,2467,1398,1063,1136,9197,1245,1325,2123,2131,2116,2163,11103,0,20300
,,Hino,3271,4069,6771,3143,3144,4121,24519,3855,3806,5172,3636,3974,3824,24267,0,48786
,Renault-Nissan Alliance,Nissan,293,595,660,287,172,291,2298,263,200,319,263,291,287,1623,0,3921
,,Renault,0,0,0,0,0,0,0,0,0,0,0,0,1,1,0,1
,GM Group,Chevrolet,8,7,4,9,6,12,46,11,11,7,14,12,4,59,0,105
,,GMC,4,0,3,3,5,1,16,4,1,5,5,4,5,24,0,40
,,Cadillac,0,0,1,2,2,1,6,3,2,4,1,3,1,14,0,20
,,Pontiac,0,0,0,0,0,0,0,0,0,1,0,0,0,1,0,1
,Ford Group,Ford,4,8,14,13,3,8,50,7,7,14,9,5,12,54,0,104
,FCA,Fiat (-2020),0,0,1,0,0,0,1,0,0,0,1,0,0,1,0,2
,,Jeep (2009-20),2,5,4,2,1,2,16,2,1,3,3,0,1,10,0,26
,,Dodge (2009-20),0,1,0,2,0,0,3,1,0,1,1,2,2,7,0,10
,,Chrysler (2009-20),1,0,0,1,0,0,2,0,0,0,0,0,1,1,0,3
,PSA,Citroen (-2020),0,0,1,1,0,0,2,0,0,0,0,0,0,0,0,2
,Daimler Group (-2021),Mercedes-Benz (-2021),2,3,22,2,3,2,34,3,3,3,4,3,7,23,0,57
,,Mitsubishi Fuso (2004-21),1272,1554,2457,1388,1186,1529,9386,1447,1504,1720,1587,1478,1910,9646,0,19032
,Mazda,Mazda,34,44,62,37,35,46,258,38,37,45,30,29,37,216,0,474
,Mitsubishi,Mitsubishi,0,0,1,0,0,0,1,0,0,0,0,0,0,0,0,1
,Tata Group,Land Rover (2008-),0,0,3,0,2,1,6,3,1,2,0,1,1,8,0,14
,Isuzu,Isuzu,3860,4919,7998,3411,3212,4549,27949,4500,4277,6544,3322,4324,4649,27616,0,55565
,Volvo Trucks Group,Volvo Trucks,39,44,73,32,29,37,254,45,36,35,39,38,22,215,0,469
,,UD Trucks (2008-),340,412,813,461,479,709,3214,504,448,729,577,710,1112,4080,0,7294
,Small and Medium OEM,Streetscooter,0,77,83,16,6,86,268,7,53,50,45,18,15,188,0,456
,,Other,0,0,0,0,1,0,1,0,0,0,0,0,0,0,0,1
Buses,VW Group,Scania (TRATON),2,1,9,2,2,3,19,4,0,0,2,0,0,6,0,25
,Toyota Group,Toyota,272,306,628,349,208,247,2010,270,250,291,215,257,246,1529,0,3539
,,Hino,189,296,590,148,91,95,1409,205,130,171,105,94,144,849,0,2258
,Renault-Nissan Alliance,Nissan,46,137,252,51,19,41,546,30,42,39,35,45,57,248,0,794
,Hyundai Kia Automotive Group,Hyundai,0,5,0,0,0,0,5,0,0,0,0,0,0,0,0,5
,Ford Group,Ford,0,0,1,0,0,0,1,0,0,0,1,0,0,1,0,2
,Daimler Group (-2021),Mercedes-Benz (-2021),0,8,0,0,0,0,8,0,1,1,1,0,0,3,0,11
,,Mitsubishi Fuso (2004-21),124,221,363,122,46,87,963,85,74,72,55,79,120,485,0,1448
,Isuzu,Isuzu,129,210,321,101,45,78,884,112,55,93,42,18,48,368,0,1252
