"name","group__name","group__brand__name","group__brand__sales__001","group__brand__sales__002","group__brand__sales__003","group__brand__sales__004","group__brand__sales__005","group__brand__sales__006","group__brand__sales__007","group__brand__sales__008","group__brand__sales__009","group__brand__sales__010","group__brand__sales__011","group__brand__sales__012","group__brand__sales__013","group__brand__sales__014","group__brand__sales__015","group__brand__sales__016"
"Mini Cars","Toyota Group","Toyota","1383","1744","2292","2155","1777","1889","11240","1906","1936","976","1348","1719","1694","9579","0","20819"
"","","Daihatsu","34976","39061","50893","32920","28047","32015","217912","32201","27536","18601","19548","30982","33798","162666","0","380578"
"","Renault-Nissan Alliance","Nissan","14574","18163","22578","9861","10322","8317","83815","7316","7607","14717","13981","11635","3596","58852","0","142667"
"","Honda","Honda","23350","25925","37958","22838","19901","23789","153761","23313","17998","17438","12838","20840","18615","111042","0","264803"
"","Suzuki","Suzuki","35988","41876","56359","32978","30919","27174","225294","26739","28312","28635","27725","33110","27916","172437","0","397731"
"","Mazda","Mazda","2481","2676","3172","1895","1802","1926","13952","2003","1766","1741","1558","2141","1361","10570","0","24522"
"","Mitsubishi","Mitsubishi","2628","4018","6264","2021","1951","2513","19395","2421","2313","4737","2541","1939","1218","15169","0","34564"
"","Subaru","Subaru","875","1472","1620","962","870","892","6691","854","601","395","348","575","640","3413","0","10104"
"","Small and Medium OEM","Other","12","2","11","7","1","0","33","3","3","0","4","1","4","15","0","48"
"Small Cars","VW Group","VW","5","2","1","4","0","1","13","3","4","2","4","3","3","19","0","32"
"","","Porsche (2013-)","0","1","5","1","2","4","13","3","2","2","6","2","3","18","0","31"
"","","Bugatti","0","0","1","0","0","0","1","0","0","0","0","0","0","0","0","1"
"","Toyota Group","Toyota","42595","49271","70437","46852","39413","45270","293838","55935","44128","34114","33961","43370","44088","255596","0","549434"
"","","Daihatsu","3820","4150","5102","2577","2565","3169","21383","3260","2665","1539","1490","5294","3676","17924","0","39307"
"","Renault-Nissan Alliance","Nissan","9569","9913","17207","7054","7068","7927","58738","8113","7304","6960","4964","6645","6076","40062","0","98800"
"","","Renault","200","279","274","82","154","241","1230","182","172","186","141","33","23","737","0","1967"
"","Stellantis","Fiat (2021-)","333","327","527","443","430","591","2651","362","426","669","433","280","647","2817","0","5468"
"","","Chrysler (2021-)","0","0","0","0","0","1","1","0","0","0","0","0","0","0","0","1"
"","","Abarth (2021-)","162","162","344","158","186","305","1317","162","139","315","150","143","263","1172","0","2489"
"","","Alfa Romeo (2021-)","0","0","2","1","1","0","4","2","0","3","2","1","0","8","0","12"
"","","Lancia (2021-)","1","1","0","0","2","0","4","1","1","0","3","1","1","7","0","11"
"","","Peugeot (2021-)","0","0","1","0","0","1","2","0","0","0","0","0","0","0","0","2"
"","","Citroen (2021-)","0","0","2","1","1","1","5","0","0","2","2","0","0","4","0","9"
"","","Opel (2021-)","0","0","1","0","0","0","1","0","0","0","0","0","0","0","0","1"
"","Ford Group","Ford","0","0","0","0","0","0","0","0","0","0","1","0","0","1","0","1"
"","Honda","Honda","11246","12264","19934","9752","7248","9217","69661","11840","9830","10555","12140","11367","10182","65914","0","135575"
"","Suzuki","Suzuki","8982","9554","12962","9065","6510","5614","52687","6277","4634","5004","6110","6357","5312","33694","0","86381"
"","Daimler Group (-2021)","Mercedes-Benz (-2021)","0","1","0","0","0","0","1","0","0","0","0","0","0","0","0","1"
"","","smart (-2021)","1","1","0","0","0","1","3","0","0","0","0","0","0","0","0","3"
"","BMW Group","BMW","0","0","0","0","1","0","1","0","1","0","0","0","0","1","0","2"
"","","MINI","0","0","0","0","0","0","0","0","0","0","0","0","2","2","0","2"
"","Mazda","Mazda","1948","2676","4457","1428","1344","898","12751","2124","2567","1024","1239","2617","2331","11902","0","24653"
"","Geely Holding Group","Volvo Cars (2011-)","0","0","0","0","0","1","1","0","0","0","0","0","0","0","0","1"
"","","Lotus (2017-)","0","2","1","0","0","0","3","3","2","1","3","2","3","14","0","17"
"","Mitsubishi","Mitsubishi","783","812","1089","572","485","448","4189","663","488","485","328","530","374","2868","0","7057"
"","Subaru","Subaru","142","174","310","119","117","136","998","150","117","56","113","161","165","762","0","1760"
"","SAIC (Shanghai Automotive Industry Corporation (Group))","MG (2006-)","0","2","0","1","0","0","3","0","2","0","2","2","1","7","0","10"
"","","Rover","3","2","4","4","3","3","19","1","2","3","3","2","6","17","0","36"
"","Small and Medium OEM","Autobianchi","2","4","8","8","6","7","35","5","4","11","10","7","10","47","0","82"
"","","Innocenti","0","0","1","0","0","0","1","0","0","0","0","0","0","0","0","1"
"","","Morgan","0","0","6","2","0","2","10","1","1","1","2","1","7","13","0","23"
"","","Saab (2010-)","0","0","0","0","0","0","0","0","0","0","1","0","0","1","0","1"
"","","Other","1","3","2","3","3","5","17","4","1","4","3","4","3","19","0","36"
"Cars","VW Group","VW","1835","2242","3577","1949","2603","5084","17290","3047","3009","4400","2264","2374","2797","17891","0","35181"
"","","Audi","1576","1833","2853","1556","1911","3125","12854","1974","1669","2124","1568","1243","1103","9681","0","22535"
"","","Porsche (2013-)","551","690","790","657","561","663","3912","451","519","504","296","478","819","3067","0","6979"
"","","Bentley","46","28","49","40","39","83","285","80","64","51","59","36","26","316","0","601"
"","","Lamborghini","46","53","63","51","31","27","271","30","37","43","25","26","25","186","0","457"
"","","Bugatti","0","1","0","0","1","1","3","0","0","0","0","0","0","0","0","3"
"","Toyota Group","Toyota","63835","65004","88969","54427","49321","56523","378079","60196","47464","40747","33926","52208","50697","285238","0","663317"
"","","Daihatsu","4","6","8","7","5","8","38","6","7","4","8","1","1","27","0","65"
"","","Lexus","5448","4758","5857","4404","4485","5398","30350","4701","3509","2819","2841","3235","3663","20768","0","51118"
"","Renault-Nissan Alliance","Nissan","12079","13444","16990","6066","6657","8338","63574","10848","10061","14096","9101","10983","9077","64166","0","127740"
"","","Renault","206","444","804","448","471","569","2942","612","408","578","363","363","433","2757","0","5699"
"","Stellantis","Fiat (2021-)","59","122","212","77","87","152","709","142","145","168","107","116","140","818","0","1527"
"","","Jeep (2021-)","953","1092","1925","936","977","1479","7362","987","992","1747","1164","1010","1009","6909","0","14271"
"","","Dodge (2021-)","36","46","68","54","45","60","309","47","55","48","43","52","47","292","0","601"
"","","Chrysler (2021-)","1","1","1","4","0","1","8","1","2","3","3","2","2","13","0","21"
"","","Abarth (2021-)","2","0","0","0","0","0","2","0","0","0","0","0","0","0","0","2"
"","","Alfa Romeo (2021-)","124","172","336","128","119","284","1163","192","196","293","127","136","222","1166","0","2329"
"","","Lancia (2021-)","0","0","0","0","0","0","0","0","0","0","0","1","0","1","0","1"
"","","Maserati (2021-)","51","70","125","44","51","145","486","102","57","123","55","98","164","599","0","1085"
"","","Peugeot (2021-)","961","1040","1914","880","1060","1535","7390","1133","624","555","365","761","1242","4680","0","12070"
"","","Citroen (2021-)","412","363","952","448","486","761","3422","575","219","340","180","387","760","2461","0","5883"
"","","Opel (2021-)","0","0","0","0","0","0","0","0","0","0","0","0","2","2","0","2"
"","","DS (2021-)","58","60","114","59","84","93","468","88","43","48","48","86","108","421","0","889"
"","GM Group","Chevrolet","34","24","44","34","58","100","294","77","57","82","88","77","32","413","0","707"
"","","Buick","4","0","1","0","1","1","7","0","0","0","2","2","0","4","0","11"
"","","GMC","2","1","5","2","2","3","15","3","4","9","5","2","6","29","0","44"
"","","Cadillac","22","51","112","33","83","84","385","55","62","75","42","70","106","410","0","795"
"","","Hummer","0","0","0","0","0","0","0","0","1","0","0","0","0","1","0","1"
"","","Pontiac","1","0","1","0","1","0","3","0","1","0","0","2","1","4","0","7"
"","Hyundai Kia Automotive Group","Hyundai","4","2","0","0","0","2","8","4","0","1","3","1","6","15","0","23"
"","Ford Group","Ford","20","46","38","47","49","63","263","45","40","40","47","29","46","247","0","510"
"","Honda","Honda","8432","11621","14214","10985","8547","11200","64999","13798","10626","10387","14131","13001","11857","73800","0","138799"
"","Suzuki","Suzuki","1041","967","1478","999","1055","636","6176","505","823","1219","1426","1591","1089","6653","0","12829"
"","Daimler Group (-2021)","Mercedes-Benz (-2021)","3660","3929","6357","3212","4327","6060","27545","4206","3722","5225","2420","3242","5317","24132","0","51677"
"","","Maybach (-2021)","0","0","0","0","0","1","1","0","0","0","0","0","0","0","0","1"
"","BMW Group","BMW","2018","3125","4818","2279","2617","4380","19237","2506","2368","4070","2014","2495","3567","17020","0","36257"
"","","MINI","1195","1691","2527","1172","1138","1413","9136","1520","1392","1651","1038","1556","1918","9075","0","18211"
"","","Rolls-Royce","11","20","33","15","12","29","120","13","14","29","13","22","29","120","0","240"
"","Mazda","Mazda","9931","11442","19904","4926","4785","5791","56779","6067","5245","6665","6270","4884","9654","38785","0","95564"
"","Geely Holding Group","Volvo Cars (2011-)","1147","1261","2039","960","1198","1825","8430","1221","1039","1716","1105","1283","1843","8207","0","16637"
"","","Lotus (2017-)","11","23","38","16","12","36","136","19","33","34","21","20","25","152","0","288"
"","Mitsubishi","Mitsubishi","2651","2954","4930","1827","1460","1454","15276","1205","2019","2777","2061","1661","2471","12194","0","27470"
"","Subaru","Subaru","9543","8200","12800","5283","4680","5323","45829","6147","5529","4595","5594","7312","6348","35525","0","81354"
"","Tata Group","Land Rover (2008-)","301","230","688","346","602","654","2821","310","248","654","98","302","340","1952","0","4773"
"","","Jaguar (2008-)","36","75","155","59","130","111","566","117","73","165","35","53","50","493","0","1059"
"","Ferrari","Ferrari (2021-)","82","78","108","87","90","121","566","100","99","124","90","108","150","671","0","1237"
"","Aston Martin","Aston Martin (2008-)","30","47","60","40","31","35","243","26","23","27","26","16","27","145","0","388"
"","SAIC (Shanghai Automotive Industry Corporation (Group))","Rover","0","1","0","0","1","0","2","0","1","0","1","1","1","4","0","6"
"","Small and Medium OEM","McLaren","13","15","17","14","19","20","98","15","16","15","15","18","12","91","0","189"
"","","Morgan","0","2","1","0","0","1","4","2","0","0","0","0","0","2","0","6"
"","","Other","14","79","586","62","501","593","1835","443","525","536","409","557","891","3361","0","5196"
"Minivan","Toyota Group","Toyota","628","721","946","1188","1021","811","5315","710","874","952","723","568","155","3982","0","9297"
"","","Daihatsu","4906","5634","7320","5712","4915","7582","36069","6619","4652","6118","5693","7331","6699","37112","0","73181"
"","Renault-Nissan Alliance","Nissan","2454","2899","3857","1997","2180","2214","15601","1968","1681","1935","1655","2126","1988","11353","0","26954"
"","Honda","Honda","2314","1993","4642","2285","1451","2417","15102","2972","1779","885","342","1958","3109","11045","0","26147"
"","Suzuki","Suzuki","5280","5525","7059","5840","5119","4526","33349","5494","4512","3414","5232","5678","4487","28817","0","62166"
"","Mazda","Mazda","438","458","647","341","371","318","2573","344","330","241","376","485","364","2140","0","4713"
"","Mitsubishi","Mitsubishi","472","707","836","385","375","421","3196","409","376","415","382","430","323","2335","0","5531"
"","Subaru","Subaru","254","348","538","333","302","356","2131","403","331","369","283","211","95","1692","0","3823"
"","Small and Medium OEM","Other","0","0","0","0","0","0","0","0","0","0","1","0","0","1","0","1"
"Mini Trucks","Toyota Group","Toyota","320","401","466","745","642","400","2974","357","513","513","293","507","147","2330","0","5304"
"","","Daihatsu","6317","6836","9013","7050","6487","7764","43467","7826","5305","7233","4821","5925","4366","35476","0","78943"
"","Renault-Nissan Alliance","Nissan","756","795","950","641","665","575","4382","646","521","694","372","623","521","3377","0","7759"
"","Honda","Honda","2189","2425","3335","1960","1348","1033","12290","652","425","394","294","223","169","2157","0","14447"
"","Suzuki","Suzuki","4485","5253","6934","4763","4272","3132","28839","4213","3090","1791","1872","3543","5924","20433","0","49272"
"","Mazda","Mazda","155","215","287","152","159","138","1106","148","112","76","61","173","149","719","0","1825"
"","Mitsubishi","Mitsubishi","272","335","467","197","271","299","1841","327","198","203","116","155","209","1208","0","3049"
"","Subaru","Subaru","343","444","445","315","400","433","2380","456","358","474","191","300","112","1891","0","4271"
"","Small and Medium OEM","Other","0","0","0","0","0","0","0","0","0","1","0","1","1","3","0","3"
"Light Trucks","Toyota Group","Toyota","10913","12958","18385","11725","10522","13557","78060","13719","11081","12732","9730","12612","10356","70230","0","148290"
"","","Daihatsu","31","22","42","23","22","24","164","26","23","21","37","24","32","163","0","327"
"","","Hino","625","788","1245","468","561","951","4638","862","861","1031","831","910","1029","5524","0","10162"
"","Renault-Nissan Alliance","Nissan","3539","4459","6769","2508","2784","3798","23857","3845","3285","3796","2863","3898","2965","20652","0","44509"
"","Daimler Group (-2021)","Mitsubishi Fuso (2004-21)","815","1077","2085","985","1122","1599","7683","1220","1074","1299","704","557","865","5719","0","13402"
"","Mazda","Mazda","456","556","814","430","426","462","3144","494","385","506","485","375","297","2542","0","5686"
"","Mitsubishi","Mitsubishi","0","0","0","0","1","0","1","0","0","0","0","0","0","0","0","1"
"","Isuzu","Isuzu","664","946","1485","591","699","888","5273","858","870","881","369","301","274","3553","0","8826"
"","","UD Trucks (2021-)","11","5","9","5","7","5","42","3","3","18","8","9","7","48","0","90"
"Trucks","VW Group","VW","0","0","0","1","0","0","1","0","0","1","0","0","0","1","0","2"
"","","Scania (TRATON)","15","30","44","18","25","25","157","27","18","24","22","27","33","151","0","308"
"","Toyota Group","Toyota","1996","2264","3381","2151","1999","2137","13928","1991","1723","1923","1608","1885","1701","10831","0","24759"
"","","Hino","3261","4117","6470","2932","3332","4483","24595","3878","4043","4732","3538","3924","3616","23731","0","48326"
"","Renault-Nissan Alliance","Nissan","215","368","606","191","106","184","1670","206","207","144","126","235","210","1128","0","2798"
"","Stellantis","Jeep (2021-)","3","1","1","3","2","0","10","2","5","0","3","2","1","13","0","23"
"","","Dodge (2021-)","0","2","2","0","0","1","5","0","0","0","1","1","0","2","0","7"
"","","Chrysler (2021-)","0","0","0","0","0","0","0","0","0","1","0","0","0","1","0","1"
"","","Citroen (2021-)","0","0","0","1","1","0","2","0","0","0","0","0","0","0","0","2"
"","GM Group","Chevrolet","2","3","6","10","7","16","44","8","12","11","11","11","8","61","0","105"
"","","GMC","1","3","9","8","6","2","29","9","3","2","2","6","2","24","0","53"
"","","Cadillac","0","0","4","3","0","1","8","2","1","2","0","1","0","6","0","14"
"","","Hummer","0","0","0","0","0","0","0","1","0","0","0","0","0","1","0","1"
"","Ford Group","Ford","4","11","18","10","8","8","59","13","12","10","9","6","13","63","0","122"
"","Daimler Group (-2021)","Mercedes-Benz (-2021)","4","4","4","1","1","3","17","1","4","2","1","2","7","17","0","34"
"","","Mitsubishi Fuso (2004-21)","916","1247","2166","1264","1254","1792","8639","1416","1445","1464","1306","1142","1137","7910","0","16549"
"","Mazda","Mazda","23","30","37","26","20","37","173","31","31","32","21","34","26","175","0","348"
"","Mitsubishi","Mitsubishi","0","0","2","0","0","0","2","0","0","0","0","0","0","0","0","2"
"","Tata Group","Land Rover (2008-)","2","1","1","0","0","2","6","2","0","0","1","1","1","5","0","11"
"","Isuzu","Isuzu","3981","5149","8229","3171","3862","5050","29442","4594","4480","5473","3094","3282","3202","24125","0","53567"
"","","UD Trucks (2021-)","273","466","964","389","470","726","3288","489","609","643","619","620","798","3778","0","7066"
"","Volvo Trucks Group","Volvo Trucks","20","17","38","29","36","33","173","30","33","47","31","23","22","186","0","359"
"","Small and Medium OEM","Streetscooter","0","23","14","0","1","0","38","0","0","0","0","0","0","0","0","38"
"Buses","VW Group","Scania (TRATON)","0","0","1","0","0","2","3","2","2","2","0","0","0","6","0","9"
"","Toyota Group","Toyota","165","244","544","281","218","239","1691","238","298","221","233","230","249","1469","0","3160"
"","","Hino","124","229","392","63","38","57","903","69","89","156","118","67","120","619","0","1522"
"","Renault-Nissan Alliance","Nissan","36","45","169","23","16","47","336","30","36","19","7","6","10","108","0","444"
"","Hyundai Kia Automotive Group","Hyundai","0","0","0","0","1","0","1","0","2","5","2","1","0","10","0","11"
"","Daimler Group (-2021)","Mercedes-Benz (-2021)","0","4","9","0","0","0","13","2","0","0","0","0","0","2","0","15"
"","","Mitsubishi Fuso (2004-21)","26","84","230","60","71","128","599","97","115","43","60","64","73","452","0","1051"
"","Isuzu","Isuzu","65","100","185","21","13","15","399","33","36","83","56","18","43","269","0","668"
